[SECTOR]
0 10 0 1 0 5
[WALLS]
2 0 4 1 0
4 1 3 3 0
3 3 1 3 0
1 3 0 2 0
0 2 2 0 0